TEU	= "countries/Deutschordensstaat.txt"
PHU = "countries/Poland-Hungary United.txt"
POM = "countries/Pommern.txt"
HAS = "countries/Hanse.txt"
HLS = "countries/Holstein.txt"
OLD = "countries/Oldenburg.txt"
MES = "countries/Mecklenburg-Strelitz.txt"
LUN = "countries/Luneburg.txt"
MAG = "countries/Magdeburg.txt"
BRN = "countries/Brandebourg.txt"
SAA= "countries/SAA.txt"
SAB= "countries/SAB.txt"
SAC= "countries/SAC.txt"
SAD= "countries/SAD.txt"
SAE= "countries/SAE.txt"
SAH= "countries/SAH.txt"
SAG= "countries/SAG.txt"
BRG= "countries/Burgundy.txt"
LOR= "countries/Lorraine.txt"
ALC= "countries/Alcase.txt"
ANH= "countries/Anhalt.txt"
BSC="countries/Braunschweig.txt"
LWW="countries/Landwirtschaftsrepublik Württemberg.txt"
AGG="countries/Augsburg.txt"
ING="countries/Ingolstadt.txt"
LAN="countries/Landshut.txt"
WUZ="countries/Wurzburg.txt"
BAM="countries/Bamberg.txt"
ANS="countries/Ansbach.txt"
NUR="countries/Nuremberg.txt"
MUN="countries/Munster.txt"
CLE="countries/Cleves.txt"
PAD="countries/Paderborn.txt"
WAL="countries/Waldecks.txt"
JUL="countries/Julich.txt"
KOL="countries/Erzstift und Kurfürstentum Köln.txt"
TRE="countries/Trier.txt"
PFA="countries/Pfalz.txt"
NSA="countries/Nassau-Saarbrucken.txt"
FRN="countries/Frankfurt.txt"
MAI="countries/Mainz.txt"
HEK="countries/Hessen-Kassel.txt"
HED="countries/Hesse-Darmstadt.txt"
NAS="countries/Nassau.txt"
HAB="countries/Habsburger Monarchie.txt"
PRO="countries/Provence.txt"
BOB="countries/Bobbio.txt"
GEN="countries/Genoa.txt"
PAM="countries/Parma.txt"
MOD="countries/Modena.txt"
MAT="countries/Mantua.txt"
SIN="countries/Siena.txt"
BYZ="countries/Byzantine.txt"
ENL="countries/England.txt"
REB="countries/Regierungsbezirk Bosnien.txt"
REH="countries/Regierungsbezirk Hyperborea.txt"
